





1111111
1C000E1
1100111
11P0111
1111111





