





111111
1C00E1
110011
11P011
111111





